"a" = (/turf/space,/area/space)
"b" = (/turf/simulated/wall,/area)
"c" = (/turf/simulated/floor/tiled,/area)
"d" = (/obj/machinery/light{dir = 1},/turf/simulated/floor/tiled,/area)
"e" = (/obj/machinery/light{icon_state = "tube1"; dir = 8},/turf/simulated/floor/tiled,/area)
"f" = (/obj/machinery/light{icon_state = "tube1"; dir = 4},/turf/simulated/floor/tiled,/area)
"g" = (/obj/effect/landmark/start,/turf/simulated/floor/tiled,/area)
"h" = (/obj/structure/cable{d2 = 2; icon_state = "0-2"; pixel_y = 0},/obj/machinery/power/apc{dir = 8; name = "west bump"; pixel_x = -24},/turf/simulated/floor/tiled,/area)
"i" = (/obj/structure/cable{d1 = 1; d2 = 2; icon_state = "1-2"; pixel_y = 0},/turf/simulated/floor/tiled,/area)
"j" = (/obj/structure/cable,/obj/machinery/power/debug_items/infinite_generator,/turf/simulated/floor/tiled,/area)
"k" = (/obj/machinery/light,/turf/simulated/floor/tiled,/area)
"l" = (/obj/effect/landmark{name = "tdome1"},/turf/simulated/floor/tiled,/area)
"m" = (/obj/machinery/atmospherics/pipe/simple/visible{tag = "icon-intact (NORTHEAST)"; icon_state = "intact"; dir = 5},/turf/simulated/floor/tiled,/area)
"n" = (/obj/machinery/atmospherics/portables_connector{tag = "icon-map_connector (WEST)"; icon_state = "map_connector"; dir = 8},/obj/machinery/portable_atmospherics/canister/air,/turf/simulated/floor/tiled,/area)
"o" = (/obj/machinery/atmospherics/pipe/simple/visible{tag = "icon-intact (EAST)"; icon_state = "intact"; dir = 4},/turf/simulated/floor/tiled,/area)
"p" = (/obj/machinery/atmospherics/pipe/simple/visible{tag = "icon-intact (SOUTHEAST)"; icon_state = "intact"; dir = 6},/turf/simulated/floor/tiled,/area)
"q" = (/obj/machinery/atmospherics/portables_connector{tag = "icon-map_connector (WEST)"; icon_state = "map_connector"; dir = 8},/obj/machinery/portable_atmospherics/canister/empty,/turf/simulated/floor/tiled,/area)
"r" = (/obj/machinery/atmospherics/unary/vent_scrubber/on{tag = "icon-map_scrubber_on (NORTH)"; icon_state = "map_scrubber_on"; dir = 1},/turf/simulated/floor/tiled,/area)
"s" = (/obj/machinery/atmospherics/unary/vent_pump/on,/turf/simulated/floor/tiled,/area)
"t" = (/obj/effect/landmark{name = "JoinLate"},/turf/simulated/floor/tiled,/area)
"u" = (/obj/machinery/light_switch{pixel_x = -25},/turf/simulated/floor/tiled,/area)
"v" = (/obj/machinery/light_switch{pixel_x = 25},/turf/simulated/floor/tiled,/area)
"w" = (/obj/effect/floor_decal/industrial/hatch/yellow,/turf/simulated/floor/tiled,/area)
"x" = (/obj/structure/ladder/up,/turf/simulated/floor/tiled,/area)
"y" = (/turf/simulated/wall,/area/shuttle/escape)
"z" = (/obj/effect/wingrille_spawn/reinforced,/turf/simulated/floor/plating,/area/shuttle/escape)
"A" = (/obj/machinery/computer/shuttle_control{shuttle_tag = "Example"},/turf/simulated/floor/plating,/area/shuttle/escape)
"B" = (/obj/structure/bed/chair{dir = 1},/obj/machinery/embedded_controller/radio/simple_docking_controller{id_tag = "example_shuttle_starboard"; pixel_x = 28},/obj/machinery/embedded_controller/radio/simple_docking_controller{id_tag = "example_shuttle_port"; pixel_x = -28},/obj/effect/shuttle_landmark,/turf/simulated/floor/plating,/area/shuttle/escape)
"C" = (/obj/machinery/light,/turf/simulated/floor/plating,/area/shuttle/escape)
"D" = (/obj/machinery/door/airlock/external/bolted{frequency = 1379; id_tag = "example_shuttle_port_hatch"},/turf/simulated/floor/plating,/area/shuttle/escape)
"E" = (/obj/machinery/door/airlock/external/bolted{frequency = 1379; id_tag = "example_shuttle_starboard_hatch"},/turf/simulated/floor/plating,/area/shuttle/escape)
"F" = (/obj/machinery/embedded_controller/radio/simple_docking_controller{id_tag = "lower_level_dock"; pixel_x = -8; pixel_y = -25},/turf/simulated/floor,/area)
"G" = (/obj/machinery/door/airlock/external/bolted{frequency = 1379; id_tag = "lower_level_dock_hatch"},/turf/simulated/floor,/area)
"H" = (/turf/simulated/floor,/area)
"I" = (/obj/effect/landmark/test/safe_turf,/turf/simulated/floor/tiled,/area)
"J" = (/obj/effect/landmark/test/space_turf,/turf/space,/area/space)

(1,1,1) = {"
aaaaaaaaaaaaaaaaaaaaaaaaaaaaaaaaaaaaaaaaaaaaaaaa
aaaaaaaaaaaaaaaaaaaaaaaaaaaaaaaaaaaaaaaaaaaaaaaa
aaaaaaaaaaaaaaaaaaaaaaaaaaaaaaaaaaaaaaaaaaaaaaaa
aaaaaaaaaaaaaaaaaaaaaaaaaaaaaaaaaaaaaaaaaaaaaaaa
aaaaaaaaaaaaaaaaaaaaaaaaaaaaaaaaaaaaaaaaaaaaaaaa
aaaaaaaaaaaaaaaaaaaaaaaaaaaaaaaaaaaaaaaaaaaaaaaa
aaaaaaaaaaaaaaaaaaaaaaaaaaaaaaaaaaaaaaaaaaaaaaaa
aaaaaaaaaaaaaaaaaaaaaaaaaaaaaaaaaaaaaaaaaaaaaaaa
aaaaaaaaaaaaaaaaaaaaaaaaaaaaaaaaaaaaaaaaaaaaaaaa
aaaaaaaaaaaaaaaaabbbbbbbbbbbbbbbaaaaaaaaaaaaaaaa
aaaaaaaaaaaaaaaaabcccdcccccdcccbaaaaaaaaaaaaaaaa
aaaaaaaaaaaaaaaaabclllcwbwcccccbaaaaaaaaaaaaaaaa
aaaaaaaaaaaaaaaaabclllcwwwccccvbaaaaaaaaaaaaaaaa
aaaaaaaaaaaaaaaaabelllxwwwccccfbaaaaaaaaaaaaaaaa
aaaaaaaaaaaaaaaaabccccccccccsccbaaaaaaaaaaaaaaaa
aaaaaaaaaaaayyyaabccccccccccmonbaaaaaaaaaaaaaaaa
aaaaaaaaaaaazAzaabucccccgccccccbaaaaaaaaaaaaaaaa
aaaaaaaaaaaazBzbbbccccIcccccpoqbaaaaaaaaaaaaaaaa
aaaaaaaaaaaaDCEGFHccccccccccrccbaaaaaaaaaaaaaaaa
aaaaaaaaaaaayyybbbectttcccccccfbaaaaaaaaaaaaaaaa
aaaaaaaaaaaaaaaaabhctttccccccccbaaaaaaaaaaaaaaaa
aaaaaaaaaaaaaaaaabictttccccccccbaaaaaaaaaaaaaaaa
aaaaaaaaaaaaaaaaabjcckccccckcccbaaaaaaaaaaaaaaaa
aaaaaaaaaaaaaaaaabbbbbbbbbbbbbbbaaaaaaaaaaaaaaaa
aaaaaaaaaaaaaaaaaaaaaaaaaaaaaaaaaaaaaaaaaaaaaaaa
aaaaaaaaaaaaaaaaaaaaaaaaaaaaaaaaaaaaaaaaaaaaaaaa
aaaaaaaaaaaaaaaaaaaaaaJaaaaaaaaaaaaaaaaaaaaaaaaa
aaaaaaaaaaaaaaaaaaaaaaaaaaaaaaaaaaaaaaaaaaaaaaaa
aaaaaaaaaaaaaaaaaaaaaaaaaaaaaaaaaaaaaaaaaaaaaaaa
aaaaaaaaaaaaaaaaaaaaaaaaaaaaaaaaaaaaaaaaaaaaaaaa
aaaaaaaaaaaaaaaaaaaaaaaaaaaaaaaaaaaaaaaaaaaaaaaa
aaaaaaaaaaaaaaaaaaaaaaaaaaaaaaaaaaaaaaaaaaaaaaaa
"}